3 13 31
###############################
#p* s   * *    *  *  4 * *    #
#   # #*# # #*#*# # #*#*#*#*# #
#  x* b    **  *      *   * * #
# # # # # #*# # #*# # # # # #*#
#     f *   x  *  *           #
# # # # # # # # # #*# #*# # # #
#*  *     *  **   4  *  5*    #
# # # # #*#*# #*#*#*# # # # # #
#*     *  *  6    *       *   #
# #*# # # # # # #*# # # # # # #
#           *   *4**    *     #
###############################