2 13 31
###############################
#p     ** *    *   *x * * *   #
# # # #*# # #*#*# # # #*#*#*# #
#   *    *  *  *   5   *   * *#
# # # # # #*# # #*#*# # # # #*#
#         x **  *  *     4    #
# # # # # # # # # #*# #*# # # #
#*  *   f    *    s  *   ***  #
# # # # #*# # # #*#*# # # # # #
#b*   **  *      *   x   s    #
# #*# # # # # # #*# # # # # # #
#     3     *   *  *          #
###############################
