4 13 31
###############################
#p* s   * *    *5  *    * *   #
#   # #*# # #*#*#*# # #*#*#*# #
#  x* b    *   *      *   * * #
# # # # # #*# # #*# # # # # #*#
#     f     x **  *  *        #
# # # # # # # # # #*# #*# # # #
#*  *         *      *        #
# # # # #*# #*# #*#*# # # # # #
#*    **  * **6   *  *        #
# #*# # # # # # #*# # # # # # #
#     7   *4*   *   * *       #
###############################