2 13 31
###############################
#p     ** *    *   *x * * *   #
# # # #*# # #*#*# # # #*#*#*# #
#   *    *  *  *  1   *   * * #
# # # # # #*# # #*#*# # # # #*#
#   1      x **  *  *    2    #
# # # # # # # # # #*# #*# # # #
#*  *   f    *    s  *   ***  #
# # # # #*# # # #*#*# # # # # #
#b*   **  *   2   *   x   s   #
# #*# # # # # # #*# # # # # # #
#     3     *   *  *  3       #
###############################
